11111111111111111111111111111111111111
1E0000000000000C00000C0000000000000001
11111111111111111111111111111100000001
1P111111111111111111111111111100000001
10111111111111111111111111111100000001
10111111111111111111111111111100000001
10111111111111111111111111111100000001
10111111111111111111111111111100000001
10111111111111111111111111111100000001
10111111111111111111111111111100000001
10111111111111111111111111111100000001
10111111111111111111111111111100000001
10111111111111111111111111111100000001
10111111111111111111111111111100000001
101C01C0101C10100C110C0C0C010100000001
100000000C00C0000000C0C0C0C000C0000001
10111111111111111111111111111100000001
11111111111111111111111111111111111111
10111111111111111111111111111100000001
11111111111111111111111111111111111111
11111111111111111111111111111111111111
