11111111111111111111111111111111
100000010000100000000000G00000E1
1000C0000000C00000000000G00000G1
100001110000C00000000000G00000G1
100001C11110C00000000000G00000G1
100011000010C00000000000G00C00G1
111101111010C00000000000G00000G1
1G0000000010000CCC000000G00000G1
100101111110C00000000000G00000G1
100000100000C00000000000G00000G1
111110100000C00000000000G00000G1
100010100000C00CCC000000G00000G1
101000100000C00000000000G00000G1
101111100000C00000000000G00000G1
1P0C0101C10C0100010C0C1C0C0000C1
1000C0000100C00000000000G00000G1
11111111111111111111111111111111
