11111111111111111111111111111111
1G0000000000000000000000000000E1
10010001011111010000100001111001
10010G0101CCCC010000100001GG1001
10011111011111010G0010G001GG1001
10010G0101CCCC01C0001C0001GG1001
10010001011111011110111101111001
10000000000000000000000000000001
1001000100000G000001000001001001
10010G01000000000001000001001001
1001C1C1011110111101001111001001
1001C1C101GG10100001001GG100G001
10011111011110100001001111001001
10000000000000000000000000000001
10000000000000000000000000000001
1P0000000000000000000000000000G1
11111111111111111111111111111111
