11111111111111111111111111111111111111
1E0000000000000C0000000000000000111111
10000101001000001010000000001010000001
10100100101010100010000000001010111111
10100101001000001010000000001010111111
10100100101010100010000000001010111111
10100101001000001010000000001010111111
10100100101010100010000000001010111111
10100101001000001010000000001010111111
10100100101010100010000000001010000001
10100101001000001010000000001010111111
10100100101010100010000000001010111111
10100101001000001010000000001010111111
10100100101010100010000000001010111111
10100101001000001010000000001010111111
10100100101010100010000000001010111111
10100101001000001010000000001010111111
10100100101010100010000000001010111111
10100101001000001010000000001010111111
1P100100101010100010000000001010000001
11111111111111111111111111111111111111
