11111111111111111111111111111111
100000000000000000000000000000G1
100000000000000000000000G00000G1
11111111111111111111111111111111
1E00C0C1C0C1C0C1C0C1C0C0C0C0C0G1
1P0C0100C10C0100010C0C1C0C0000C1
11111111111111111111111111111111
