11111111111111111111111111111111
1E10C0C0C0C0C0C0C0C0C0C0C0C0C011
10001111111111101111101111111C01
11100011111111101000000000000101
11001000001100000011111111110101
10011101100001011011111111110101
11001000111C11011000C0CCC1010101
1000001001C011000011111111110101
10111011000000111011111111110101
10001010011010011000000100010101
10101000111001000111010001000001
10101110111011110011011111111111
10100000000000010000000010000001
10101111111111010C111C1C1C110111
1P1C0000C00C0000010C0C1C0C0000C1
11111111111111111111111111111111
