11111111111111111111111111111111
1G0G0G0G0G0G0G0G0G0G0G0G0G0G0G01
10G0G0G0G0G0G0G0G0G0G0G0G0G0G0G1
1G0G0G0G0G0G0G0G0G0G0G0G0G0G0G01
10G0G0G0G0G0G0G0G0G0G0G0G0G0G0G1
11111111111111111111111111111111
100G1000001C10C0001G010C010G0001
10100010101010110101000101010101
1P101GC0100010000CG0010101001E01
101000101111C0110101000101100101
100G1000000001C00G1001GC000001C1
11111111111111111111111111111111
10G0G0G0G0G0G0G0G0G0G0G0G0G0G0G1
1G0G0G0G0G0G0G0G0G0G0G0G0G0G0G01
10G0G0G0G0G0G0G0G0G0G0G0G0G0G0G1
1G0G0G0G0G0G0G0G0G0G0G0G0G0G0G01
11111111111111111111111111111111
