11111111111111111111111111111111
100000000000000000000000000000E1
10C000C0CCCCC0C0000C0000CCCCC001
10C000C0C00000C0000C0000CGGGC001
10CCCCC0CCCCC0C0000C0000CGGGC001
10C000C0C00000C0000C0000CGGGC001
10C000C0CCCCC0CCCC0CCCC0CCCCC001
10000000000000000000000000000001
10C000C0CCCCC0CCCC00C0000CCCC001
10C000C0CGGGC0CGGGC0C0000CGGGC01
10C0C0C0CGGGC0CCCC00C0000CGGGC01
10CCCCC0CGGGC0C0C000C0000CGGGC01
100C0C00CCCCC0C00CC0CCCC0CCCC001
10000000000000000000000000000001
10000000000000000000000000000001
1P000000000000000000000000000001
11111111111111111111111111111111
