11111111111111111111111111111111
10000G00000G00000G00000G00000GE1
1000GGG000GGG000GGG000GGG000GGG1
10000G00000G00000G00000G00000G01
10G00000G00000G00000G00000G00001
1GGG000GGG000GGG000GGG000GGG0001
10G00000G00000G00000G00000G00001
10000G00000G00000G00000G00000G01
1000GGG000GGG000GGG000GGG000GGG1
10000G00000G00000G00000G00000G01
10G00000G00000G00000G00000G00001
1GGG000GGG000GGG000GGG000GGG0001
10G00000G00000G00000G00000G00001
100C0G00000G00000G00000G00000G01
1000GGG000GGG000GGG000GGG000GGG1
1P000G00000G00000G00000G00000G01
11111111111111111111111111111111
