11111111111111111111111111111111
100000000000000C0000000000000001
1C1111111111111111111111111111C1
10000000000G1000000C000000000001
11111111111C011111101111111C1111
101C1GC01000000000000000000000G1
1110101010110111C111011111111101
1G000000001001P000E1000000000001
111111111110111111111011111111C1
1000G000000000000000001000000001
10110111C11111111111101010111111
100100000000000000GC000010000001
11C10101111111111101011111111101
1G000100000100000001000000010001
1011111111C101111111111111000111
1C0000000000000000C00000000100C1
11111111111111111111111111111111
