11111111111111111111111111111111
1GCCC1CCCCCCC1CCCE10000000000001
1C11CCC11111CCC11C10001000100001
1C11C1CCC1CCC1C11C10001000101001
1CCCC111C1C111CCCC10001000101001
1C11C1CCCCCCC1C11C10001000101001
1CGCCCC11111CCCCGC10001000101001
1CCGC1CCGCGCC1CGCC10001000101001
1111C1C11111C1C11110000000000001
1CCCCCCCC1CCCCCCCC10010100100001
1C11C111C1C111C11C10010100100001
1CC1CCGCCCCCGCC1CC10010100100001
11C1C1C11111C1C1C110010100100001
1CCCC1CCC1CCC1CCCC10010100111101
1C111111C1C111111C10010100100001
1PCCCCCCCCCCCCCCCG10000000000001
11111111111111111111111111111111
