11111111111111111111111111111111
1C0000000000000C00000C0000000001
1E111111111111111111111111111101
1P1C01C0101C10100C110C0C0C010101
100000000C00C0000000C0C0C0C000C1
11111111111111111111111111111111
