11111111111111111111111111111111
100000000000000000000000000000E1
10100010111110100001000011111001
101000101CCCC010000100001GGG1001
1011111011111010000100001GGG1001
101000101CCCC010000100001GGG1001
10100010111110111101111011111001
10000000000000000000000000000001
10100010111110111110100001111001
101000101GGG101GGG10100001GG1101
101C1C101GGG10111110100001GGG101
101C1C101GGG10101000100001GG1101
10111110111110101110111101111001
10000000000000000000000000000001
10000000000000000000000000000001
1P000000000000000000000000000001
11111111111111111111111111111111
