
NO ./path_to_the_north_texture
SO ./path_to_the_south_texture
WE ./path_to_the_west_texture
EA ./path_to_the_east_texture

C 225,30,0
F 220,100,0

11111111111111111111111111111111
10000000000000000000000000000001
1011111111111111111111111111110000000
1N10010010101010001100000001010111111
10000000000000000000000000000001
11111111111111111111111111111111
