
NO ./path_to_the_north_texture
SO ./path_to_the_south_texture
WE ./path_to_the_west_texture
EA ./path_to_the_east_texture

C 225,30,0
F 220,100,0

11111111111111111111111111111111
10000000000000000000000000000001
10111111111111111111111111111100
1N100100101010100011000000010101
10000000000000000000000000000001
11111111111111111111111111111111
